111111111
1P00C0C01
1C0E11E11
111111111