1111111111111
100PC10000C01
1C00010000001
1000010100001
100000C10E001
1111111111111